99 12 99 99 12 99 99 12 99 99 12 99 99 12 99 99 12 99
12 99 99 12 99 99 12 99 99 12 99 99 12 99 99 12 99 99
99 99 99 99 99 99 99 99 99 99 99 99 99 99 12 99 99 12
99 12 99 99 99 99 99 99 99 99 99 99 99 99 99 99 12 99
12 99 99 99 99 99 99 99 99 99 99 99 99 99 99 12 99 99
99 99 99 99 99 12 99 99 12 99 99 99 99 99 12 99 99 12
99 12 99 99 12 99 99 12 99 99 12 99 99 99 99 99 12 99
12 99 99 99 99 99 99 99 99 12 99 99 99 99 99 12 99 99
99 99 99 99 99 12 99 99 12 99 99 99 99 99 12 99 99 12
99 12 99 99 99 99 99 99 99 99 12 99 99 99 99 99 12 99
12 99 99 99 99 99 99 99 99 12 99 99 12 99 99 12 99 99
99 99 12 99 99 12 99 99 12 99 99 12 99 99 12 99 99 12
99 12 99 99 12 99 99 12 99 99 12 99 99 12 99 99 12 99
12 99 99 12 99 99 12 99 99 12 99 99 12 99 99 12 99 99
99 99 99 99 99 99 99 99 99 99 99 99 99 99 12 99 99 12
99 12 99 99 99 99 99 99 99 99 99 99 99 99 99 99 12 99
12 99 99 99 99 99 99 99 99 99 99 99 99 99 99 12 99 99
99 99 99 99 99 12 99 99 12 99 99 99 99 99 12 99 99 12
99 12 99 99 12 99 99 12 99 99 12 99 99 99 99 99 12 99
12 99 99 99 99 99 99 99 99 12 99 99 99 99 99 12 99 99
99 99 99 99 99 12 99 99 12 99 99 99 99 99 12 99 99 12
99 12 99 99 99 99 99 99 99 99 12 99 99 99 99 99 12 99
12 99 99 99 99 99 99 99 99 12 99 99 12 99 99 12 99 99
99 99 12 99 99 12 99 99 12 99 99 12 99 99 12 99 99 12