00 01 02 00 01 02 00 01 02 00 01 02 00 01 02 00 01 02
01 02 00 01 02 00 01 02 00 01 02 00 01 02 00 01 02 00
02 00 11 04 04 04 04 04 04 04 04 04 04 05 01 02 00 01
00 01 10 03 03 03 03 03 03 03 03 03 03 06 02 00 01 02
01 02 10 03 08 08 08 08 08 08 08 03 03 06 00 01 02 00
02 00 10 06 00 01 02 00 01 02 00 10 03 06 01 02 00 01
00 01 10 06 01 11 05 01 02 00 01 10 03 06 02 00 01 02
01 02 10 06 02 09 07 02 00 01 02 10 03 06 00 01 02 00
02 00 10 06 00 01 02 00 01 02 00 10 03 06 01 02 00 01
00 01 10 03 04 04 04 05 02 00 01 09 08 07 02 00 01 02
01 02 09 08 08 08 08 07 00 01 02 00 01 02 00 01 02 00
02 00 01 02 00 01 02 00 01 02 00 01 02 00 01 02 00 01
00 01 02 00 01 02 00 01 02 00 01 02 00 01 02 00 01 02
01 02 00 01 02 00 01 02 00 01 02 00 01 02 00 01 02 00
02 00 11 04 04 04 04 04 04 04 04 04 04 05 01 02 00 01
00 01 10 03 03 03 03 03 03 03 03 03 03 06 02 00 01 02
01 02 10 03 08 08 08 08 08 08 08 03 03 06 00 01 02 00
02 00 10 06 00 01 02 00 01 02 00 10 03 06 01 02 00 01
00 01 10 06 01 11 05 01 02 00 01 10 03 06 02 00 01 02
01 02 10 06 02 09 07 02 00 01 02 10 03 06 00 01 02 00
02 00 10 06 00 01 02 00 01 02 00 10 03 06 01 02 00 01
00 01 10 03 04 04 04 05 02 00 01 09 08 07 02 00 01 02
01 02 09 08 08 08 08 07 00 01 02 00 01 02 00 01 02 00
02 00 01 02 00 01 02 00 01 02 00 01 02 00 01 02 00 01